1 1 1 1 1 1 1 1 1 1 1 1 1 1 1 1 1 1 1 1 1 1 1 1 1 1 1 1 1 1 1 1 1 1 1 1 1 1 1 1 1 1
1 4 0 2 8 8 2 2 2 2 2 2 2 2 2 2 2 2 2 2 2 2 2 2 2 2 2 2 2 2 2 2 8 8 2 2 2 2 2 2 8 1
1 4 0 0 3 3 0 0 0 0 0 0 0 0 0 0 0 0 0 0 0 0 0 0 0 0 0 0 0 0 0 0 3 3 0 0 0 0 0 0 3 1
1 4 0 0 3 3 0 0 0 0 0 0 0 0 0 0 0 0 0 0 0 0 0 0 0 0 0 0 0 0 0 0 3 3 0 0 0 0 0 0 3 1
1 4 0 0 3 7 2 2 2 2 2 2 2 8 0 0 3 2 2 2 2 8 0 0 3 8 0 0 0 0 0 0 3 3 0 0 3 8 0 0 3 1
1 4 0 0 3 3 2 2 2 2 2 2 2 2 0 0 7 2 2 2 8 3 0 0 3 3 0 0 0 0 0 0 3 3 0 0 3 3 0 0 3 1
1 4 0 0 3 3 0 0 0 0 0 0 0 0 0 0 0 0 0 0 3 3 0 0 3 3 0 0 0 0 0 0 3 3 0 0 3 3 0 0 3 1
1 4 0 0 3 3 0 0 0 0 0 0 0 0 0 0 0 0 0 0 3 3 0 0 3 3 0 0 0 0 0 0 3 3 0 0 3 3 0 0 3 1
1 4 0 0 3 3 0 0 3 8 0 0 3 8 0 0 0 0 0 0 3 3 0 0 3 7 2 2 2 2 2 2 2 3 0 0 3 3 0 0 3 1
1 4 0 0 7 2 0 0 3 3 0 0 3 3 0 0 0 0 0 0 3 3 0 0 7 2 2 2 8 3 2 2 2 2 0 0 3 3 0 0 3 1
1 4 0 0 0 0 0 0 3 3 0 0 3 3 0 0 0 0 0 0 3 3 0 0 0 0 0 0 3 3 0 0 0 0 0 0 3 3 0 0 3 1
1 4 0 0 0 0 0 0 3 3 0 0 3 3 0 0 0 0 0 0 3 3 0 0 0 0 0 0 3 3 0 0 0 0 0 0 3 3 0 0 3 1
1 4 2 2 2 2 2 2 2 7 2 2 2 7 2 2 2 2 2 2 2 7 2 2 2 8 0 0 3 7 2 2 2 8 0 0 3 7 2 2 8 1
1 4 2 2 2 2 2 2 2 2 2 2 8 3 2 2 2 2 2 2 8 3 2 2 2 2 0 0 7 2 2 2 2 2 0 0 7 2 2 2 8 1
1 4 0 0 0 0 0 0 0 0 0 0 3 3 0 0 0 0 0 0 3 3 0 0 0 0 0 0 0 0 0 0 0 0 0 0 0 0 0 0 3 1
1 4 0 0 0 0 0 0 0 0 0 0 3 3 0 0 0 0 0 0 3 3 0 0 0 0 0 0 0 0 0 0 0 0 0 0 0 0 0 0 3 1
1 4 0 0 3 8 0 0 0 0 0 0 3 3 0 0 3 8 0 0 3 3 0 0 3 2 2 2 2 2 2 2 2 8 0 0 0 0 0 0 3 1
1 4 0 0 3 3 0 0 0 0 0 0 3 3 0 0 3 3 0 0 7 2 0 0 7 2 2 2 2 2 2 2 8 3 0 0 0 0 0 0 3 1
1 4 0 0 3 3 0 0 0 0 0 0 3 3 0 0 3 3 0 0 0 0 0 0 0 0 0 0 0 0 0 0 3 3 0 0 0 0 0 0 3 1
1 4 0 0 3 3 0 0 0 0 0 0 3 3 0 0 3 3 0 0 0 0 0 0 0 0 0 0 0 0 0 0 3 3 0 0 0 0 0 0 3 1
1 4 0 0 3 7 2 2 2 2 2 2 2 3 0 0 3 7 2 2 2 2 2 2 2 8 0 0 0 0 0 0 3 7 2 2 2 2 2 2 8 1
1 4 0 0 7 2 2 2 2 2 2 2 8 3 0 0 3 3 2 2 2 2 2 2 8 3 0 0 0 0 0 0 3 3 2 2 2 2 2 2 8 1
1 4 0 0 0 0 0 0 0 0 0 0 3 3 0 0 3 3 0 0 0 0 0 0 3 3 0 0 0 0 0 0 3 3 0 0 0 0 0 0 3 1
1 0 0 0 0 0 0 0 0 0 0 0 3 3 0 0 3 3 0 0 0 0 0 0 3 3 0 0 0 0 0 0 3 3 0 0 0 0 0 0 3 1
1 4 0 0 0 3 2 2 2 8 0 0 3 3 0 0 3 7 2 2 2 8 0 0 3 7 2 2 2 2 2 2 2 7 2 2 2 8 0 0 3 1
1 4 0 0 0 7 2 2 8 3 0 0 3 3 0 0 7 2 2 2 8 3 0 0 7 2 2 2 2 2 2 2 2 2 2 2 2 2 0 0 3 1
1 4 0 0 0 0 0 0 3 3 0 0 3 3 0 0 0 0 0 0 3 3 0 0 0 0 0 0 0 0 0 0 0 0 0 0 0 0 0 0 3 1
1 4 0 0 0 0 0 0 3 3 0 0 3 3 0 0 0 0 0 0 3 3 0 0 0 0 0 0 0 0 0 0 0 0 0 0 0 0 0 0 3 1
1 4 2 2 2 2 2 2 2 3 0 0 3 7 2 2 2 8 0 0 3 7 2 2 2 8 0 0 3 8 0 0 3 2 2 2 2 8 0 0 3 1
1 4 2 2 2 2 2 2 2 2 0 0 7 2 2 2 8 3 0 0 7 2 2 2 8 3 0 0 3 3 0 0 7 2 2 2 8 3 0 0 3 1
1 4 0 0 0 0 0 0 0 0 0 0 0 0 0 0 3 3 0 0 0 0 0 0 3 3 0 0 3 3 0 0 0 0 0 0 3 3 0 0 3 1
1 4 0 0 0 0 0 0 0 0 0 0 0 0 0 0 3 3 0 0 0 0 0 0 3 3 0 0 3 3 0 0 0 0 0 0 3 3 0 0 3 1
1 4 0 0 3 2 2 2 2 2 2 2 2 8 0 0 3 7 2 2 2 8 0 0 3 7 2 2 2 7 2 2 2 8 0 0 3 3 0 0 3 1
1 4 0 0 7 2 2 2 2 2 2 2 8 3 0 0 3 3 2 2 2 2 0 0 3 3 2 2 2 2 2 2 8 3 0 0 3 3 0 0 3 1
1 4 0 0 0 0 0 0 0 0 0 0 3 3 0 0 3 3 0 0 0 0 0 0 3 3 0 0 0 0 0 0 3 3 0 0 3 3 0 0 3 1
1 4 0 0 0 0 0 0 0 0 0 0 3 3 0 0 3 3 0 0 0 0 0 0 3 3 0 0 0 0 0 0 3 3 0 0 3 3 0 0 3 1
1 4 0 0 3 2 2 2 2 8 0 0 3 7 2 2 2 3 0 0 3 2 2 2 2 3 0 0 3 8 0 0 3 3 0 0 3 3 0 0 3 1
1 4 0 0 7 2 2 2 8 3 0 0 7 2 2 2 2 2 0 0 7 2 2 2 2 2 0 0 3 3 0 0 7 2 0 0 3 3 0 0 3 1
1 4 0 0 0 0 0 0 3 3 0 0 0 0 0 0 0 0 0 0 0 0 0 0 0 0 0 0 3 3 0 0 0 0 0 0 3 3 0 0 3 1
1 4 0 0 0 0 0 0 3 3 0 0 0 0 0 0 0 0 0 0 0 0 0 0 0 0 0 0 3 3 0 0 0 0 0 0 3 3 0 0 3 1
1 5 6 6 6 6 6 6 6 6 6 6 6 6 6 6 6 6 6 6 6 6 6 6 6 6 6 6 6 6 6 6 6 6 6 6 6 6 6 6 6 1
1 1 1 1 1 1 1 1 1 1 1 1 1 1 1 1 1 1 1 1 1 1 1 1 1 1 1 1 1 1 1 1 1 1 1 1 1 1 1 1 1 1
