1 1 1 1 1 1 1 1 1 1 1 1 1 1 1 1 1 1 1 1 1 1 1 1 1 1 1 1 1 1 1 1 1 1 1 1 1 1 1 1 1 1 1 1 1 1 1 1
1 4 2 8 2 2 2 2 2 2 2 2 2 2 2 2 8 2 2 2 2 2 2 2 2 2 2 2 2 2 2 2 2 2 2 2 2 2 2 8 2 2 2 2 2 2 8 1
1 4 0 3 0 0 0 0 0 0 0 0 0 0 0 0 3 0 0 0 0 0 0 0 0 0 0 0 0 0 0 0 0 0 0 0 0 0 0 3 0 0 0 0 0 0 3 1
1 4 0 7 2 2 0 0 0 0 0 3 0 0 0 0 3 0 0 0 0 0 0 2 2 2 2 0 0 0 0 0 3 0 0 0 0 0 0 3 0 0 0 0 0 0 3 1
1 4 0 0 0 0 0 0 0 0 0 3 0 0 0 0 0 0 0 0 0 0 0 0 0 0 0 0 0 0 0 0 3 0 0 0 0 0 0 0 0 0 0 0 0 0 3 1
1 4 0 0 0 3 2 2 2 2 2 2 2 2 2 2 2 2 2 2 2 2 2 2 2 2 2 2 2 2 8 2 2 2 2 2 2 2 2 2 2 2 8 0 0 2 8 1
1 4 0 3 0 3 0 0 0 0 0 0 0 0 0 0 0 0 0 0 0 0 0 0 0 0 0 0 0 0 3 0 0 0 0 0 0 0 0 0 0 0 3 0 0 0 3 1
1 4 0 3 0 3 0 0 0 0 0 0 0 0 0 0 0 0 0 0 0 0 0 0 0 0 0 0 0 0 3 0 0 0 0 0 0 0 0 0 0 0 3 0 3 0 3 1
1 4 0 3 0 3 0 0 0 0 0 0 0 0 0 0 0 0 0 0 0 0 0 0 0 0 0 0 0 0 3 0 0 0 0 0 0 0 0 0 0 0 3 0 3 0 3 1
1 4 0 0 0 3 0 0 0 0 2 2 2 8 0 0 0 0 0 0 0 0 2 2 2 2 8 0 0 0 3 0 0 0 0 0 0 0 3 0 0 0 3 0 3 0 3 1
1 4 0 0 0 3 0 0 0 0 0 0 0 3 0 0 0 0 6 0 0 0 0 0 0 0 3 0 0 0 3 0 0 0 0 0 0 0 3 0 0 0 3 0 0 0 3 1
1 4 0 0 0 3 0 0 0 0 0 2 2 8 0 0 0 2 6 2 0 0 0 0 0 0 3 0 0 0 3 0 0 0 0 0 0 0 3 0 0 0 3 0 0 0 3 1
1 0 0 0 0 3 0 0 0 0 0 0 0 3 0 0 0 0 2 0 0 0 0 0 0 0 3 0 0 0 3 0 0 6 6 6 0 0 3 0 0 0 0 0 0 0 3 1
1 4 0 0 0 3 0 0 0 0 0 0 0 3 0 0 0 0 0 0 0 0 3 2 2 2 2 0 0 0 3 0 0 6 6 6 0 0 3 0 0 0 0 0 0 0 3 1
1 4 2 2 2 8 0 0 0 0 0 0 6 6 6 0 0 0 0 0 0 0 3 0 0 0 0 0 0 0 3 0 0 2 2 2 0 0 3 0 0 0 0 0 0 0 3 1
1 6 0 0 0 3 0 0 0 0 0 6 6 1 6 6 0 0 0 0 0 0 3 0 0 0 0 0 0 0 3 0 0 0 0 0 0 0 3 0 0 0 3 0 0 0 3 1
1 0 0 0 0 3 0 0 6 0 0 2 6 1 6 2 0 0 0 0 0 0 3 0 0 0 0 0 0 0 3 0 0 0 0 0 0 0 3 0 0 0 3 0 0 0 3 1
1 8 0 0 0 3 0 2 6 2 0 0 2 2 2 0 0 0 6 0 0 0 3 0 0 0 2 2 2 2 2 0 0 0 0 0 0 0 3 0 0 0 3 2 2 0 3 1
1 4 0 0 0 3 0 0 2 0 0 0 0 0 0 0 0 2 6 2 0 0 3 0 0 0 0 0 0 0 0 0 0 0 0 0 0 0 3 0 0 0 3 0 0 0 3 1
1 4 0 0 0 3 0 0 0 0 0 0 0 0 0 0 0 0 2 0 0 0 3 0 0 0 0 0 0 0 0 0 0 0 0 0 0 0 3 0 0 0 3 0 0 0 3 1
1 4 0 0 0 3 0 0 0 0 0 0 0 0 0 0 0 0 0 0 0 0 3 0 0 0 0 0 0 0 0 0 0 0 0 0 0 0 3 0 0 0 3 0 0 0 3 1
1 4 0 0 0 3 2 2 2 2 2 2 2 2 2 2 2 2 2 2 2 2 2 8 2 2 2 2 2 2 2 2 2 2 2 2 2 2 2 8 2 2 2 0 2 2 8 1
1 4 0 0 2 2 0 0 0 0 0 0 0 0 0 0 0 0 0 0 0 0 0 3 0 0 0 0 0 0 0 0 0 0 0 0 0 0 0 3 0 0 0 0 0 0 3 1
1 4 0 0 0 0 0 0 0 0 0 0 0 0 0 3 0 0 0 0 0 0 0 3 0 0 2 2 2 0 0 3 0 0 2 2 2 0 0 3 0 0 0 0 0 0 3 1
1 4 0 0 0 0 0 3 0 0 0 0 0 0 0 3 0 0 0 0 0 0 0 0 0 0 0 0 0 0 0 3 0 0 0 0 0 0 0 0 0 0 0 0 0 0 3 1
1 5 6 6 6 6 6 6 6 6 6 6 6 6 6 6 6 6 6 6 6 6 6 6 6 6 6 6 6 6 6 6 6 6 6 6 6 6 6 6 6 6 6 6 6 6 6 1
1 1 1 1 1 1 1 1 1 1 1 1 1 1 1 1 1 1 1 1 1 1 1 1 1 1 1 1 1 1 1 1 1 1 1 1 1 1 1 1 1 1 1 1 1 1 1 1
