4 4 4 4 4 4 4 4 4 4 4 4 4 4 4 4 4 4 4 4 4 4 4 4 4 4 4 4 4 4 4 4 4 4 4 4 4 4 4 4 4 4 4 4 4 4 4 4
4 1 1 1 1 1 1 1 1 1 1 1 1 1 1 1 1 1 1 1 1 1 1 1 1 1 1 1 1 1 1 1 1 1 1 1 1 1 1 1 1 1 1 1 1 1 1 4
4 1 5 1 5 5 5 5 5 5 5 5 5 5 5 5 1 5 5 5 5 5 5 5 5 5 5 5 5 5 5 5 5 5 5 5 5 5 5 1 5 5 5 5 5 5 1 4
4 1 5 1 1 1 5 5 5 5 5 1 5 5 5 5 1 5 5 5 5 5 5 1 1 1 1 5 5 5 5 5 1 5 5 5 5 5 5 1 5 5 5 5 5 5 1 4
4 1 5 5 5 5 5 5 5 5 5 1 5 5 5 5 5 5 5 5 5 5 5 5 5 5 5 5 5 5 5 5 1 5 5 5 5 5 5 5 5 5 5 5 5 5 1 4
4 1 5 5 5 1 1 1 1 1 1 1 1 1 1 1 1 1 1 1 1 1 1 1 1 1 1 1 1 1 1 1 1 1 1 1 1 1 1 1 1 1 1 5 1 1 1 4
4 1 5 1 5 1 5 5 5 5 5 5 5 5 5 5 5 5 5 5 5 5 5 5 5 5 5 5 5 5 5 5 5 5 5 5 5 5 5 5 5 5 1 5 5 5 1 4
4 1 5 1 5 1 5 5 5 5 5 5 5 5 5 5 5 5 5 5 5 5 5 5 5 5 5 5 5 5 5 5 5 5 5 5 5 5 5 5 5 5 1 5 1 5 1 4
4 1 5 1 5 1 5 5 5 5 5 5 5 5 5 5 5 5 5 5 5 5 5 5 5 5 5 5 5 5 5 5 5 5 5 5 5 5 5 5 5 5 1 5 1 5 1 4
4 1 5 5 5 1 5 5 5 5 1 1 1 1 5 5 5 5 5 5 5 5 1 1 1 1 1 5 5 5 5 5 5 5 5 5 5 5 1 5 5 5 1 5 1 5 1 4
4 1 5 5 5 1 5 5 5 5 5 5 5 1 5 5 5 5 1 5 5 5 5 5 5 5 1 5 5 5 5 5 5 5 5 5 5 5 1 5 5 5 1 5 5 5 1 4
4 1 5 5 5 1 5 5 5 5 5 1 1 1 5 5 5 1 1 1 5 5 5 5 5 5 1 5 5 5 5 5 5 5 5 5 5 5 1 5 5 5 1 5 5 5 1 4
4 3 5 5 5 1 5 5 5 5 5 5 5 1 5 5 5 5 1 5 5 5 5 5 5 5 1 5 5 5 5 5 5 1 1 1 5 5 1 5 5 5 5 5 5 5 1 4
4 1 5 5 5 1 5 5 5 5 5 5 5 1 5 5 5 5 5 5 5 5 1 1 1 1 1 5 5 5 1 5 5 1 5 1 5 5 1 5 5 5 5 5 5 5 1 4
4 1 1 1 1 1 5 5 5 5 5 5 1 1 1 5 5 5 5 5 5 5 1 5 5 5 5 5 5 5 1 5 5 1 1 1 5 5 1 5 5 5 5 5 5 5 1 4
4 1 5 5 5 1 5 5 5 5 5 1 1 5 1 1 5 5 5 5 5 5 1 5 5 5 5 5 5 5 1 5 5 5 5 5 5 5 1 5 5 5 1 5 5 5 1 4
4 1 5 5 5 5 5 5 1 5 5 1 1 5 1 1 5 5 5 5 5 5 1 5 5 5 5 5 5 5 1 5 5 5 5 5 5 5 1 5 5 5 1 5 5 5 1 4
4 1 5 5 5 1 5 1 1 1 5 5 1 1 1 5 5 5 1 5 5 5 1 5 5 5 1 1 1 1 1 5 5 5 5 5 5 5 1 5 5 5 1 1 1 5 1 4
4 1 5 5 5 1 5 5 1 5 5 5 5 5 5 5 5 1 1 1 5 5 1 5 5 5 5 5 5 5 5 5 5 5 5 5 5 5 1 5 5 5 1 5 5 5 1 4
4 1 5 5 5 1 5 5 5 5 5 5 5 5 5 5 5 5 1 5 5 5 1 5 5 5 5 5 5 5 5 5 5 5 5 5 5 5 1 5 5 5 1 5 5 5 1 4
4 1 5 5 5 1 5 5 5 5 5 5 5 5 5 5 5 5 5 5 5 5 1 5 5 5 5 5 5 5 5 5 5 5 5 5 5 5 1 5 5 5 1 5 5 5 1 4
4 1 5 5 5 1 1 1 1 1 1 1 1 1 1 1 1 1 1 1 1 1 1 1 1 1 1 1 1 1 1 1 1 1 1 1 1 1 1 1 1 1 1 5 1 1 1 4
4 1 5 5 1 1 5 5 5 5 5 5 5 5 5 5 5 5 5 5 5 5 5 1 5 5 5 5 5 5 5 5 5 5 5 5 5 5 5 1 5 5 5 5 5 5 1 4
4 1 5 5 5 5 5 5 5 5 5 5 5 5 5 1 5 5 5 5 5 5 5 1 5 5 1 1 1 5 5 1 5 5 1 1 1 5 5 1 5 5 5 5 5 5 1 4
4 1 5 5 5 5 5 1 5 5 5 5 5 5 5 1 5 5 5 5 5 5 5 5 5 5 5 5 5 5 5 1 5 5 5 5 5 5 5 5 5 5 5 5 5 5 1 4
4 1 1 1 1 1 1 1 1 1 1 1 1 1 1 1 1 1 1 1 1 1 1 1 1 1 1 1 1 1 1 1 1 1 1 1 1 1 1 1 1 1 1 1 1 1 1 4
4 4 4 4 4 4 4 4 4 4 4 4 4 4 4 4 4 4 4 4 4 4 4 4 4 4 4 4 4 4 4 4 4 4 4 4 4 4 4 4 4 4 4 4 4 4 4 4