1 1 1 1 1 1 1 1 1 1 1 1 1 1 1 1 1 1 1 1 1 1 1 1 1 1 1 1 1 1
1 4 2 8 2 2 2 2 2 2 2 2 2 2 2 2 2 8 2 2 2 8 2 2 2 2 2 2 8 1
1 4 0 3 0 0 0 0 0 0 0 0 0 0 0 0 0 3 0 0 0 3 0 0 0 0 0 0 3 1
1 4 0 3 2 2 2 2 0 2 2 8 0 3 0 0 0 3 0 3 0 3 0 3 2 2 2 2 8 1
1 4 0 3 0 0 0 0 0 0 0 3 0 3 0 0 0 3 0 3 0 3 0 3 0 0 0 0 3 1
1 4 0 3 0 3 0 3 0 0 0 3 0 7 2 8 2 2 0 3 0 3 0 3 0 2 8 0 3 1
1 4 0 0 0 3 0 3 0 0 0 3 0 0 0 3 0 0 0 3 0 0 0 0 0 0 3 0 3 1
1 4 2 2 2 2 0 3 2 2 2 8 2 2 0 7 2 2 0 7 2 8 2 2 2 2 2 0 3 1
1 4 0 0 0 0 0 3 0 0 0 3 0 0 0 0 0 0 0 0 0 3 0 0 0 0 0 0 3 1
1 4 0 3 0 0 0 3 0 3 0 3 0 2 2 2 2 8 0 0 0 3 0 0 0 3 2 2 8 1
1 4 0 3 0 0 0 3 0 3 0 0 0 0 0 0 0 3 0 0 0 3 0 0 0 3 0 0 3 1
1 4 0 7 2 2 2 8 0 3 2 2 2 8 0 0 0 3 2 2 2 2 0 2 2 2 0 2 8 1
1 4 0 0 0 0 0 3 0 3 0 0 0 3 0 0 0 3 0 0 0 0 0 0 0 0 0 0 3 1
1 4 0 2 2 8 0 3 0 7 2 8 0 7 2 2 2 2 2 2 0 3 2 2 2 2 8 0 3 1
1 4 0 0 0 3 0 3 0 0 0 3 0 0 0 0 0 0 0 0 0 3 0 0 0 0 3 0 3 1
1 4 2 2 2 2 0 7 2 8 0 7 2 8 0 3 0 2 2 8 0 3 0 2 2 2 2 0 3 1
1 4 0 0 0 0 0 0 0 3 0 0 0 3 0 3 0 0 0 3 0 3 0 0 0 0 0 0 3 1
1 4 0 2 2 2 2 8 0 3 2 2 0 3 2 2 2 8 0 3 0 7 8 0 3 2 2 2 8 1
1 4 0 0 0 0 0 3 0 3 0 0 0 3 0 0 0 3 0 3 0 0 3 0 3 0 0 0 3 1
1 4 0 2 2 8 0 7 2 2 0 2 2 2 0 3 0 3 0 7 2 2 2 0 3 0 0 0 3 1
1 4 0 0 0 3 0 0 0 0 0 0 0 0 0 3 0 0 0 0 0 0 0 0 0 0 0 0 3 1
1 8 6 6 6 6 6 6 6 6 6 6 6 6 6 6 6 6 6 6 6 6 6 6 6 6 6 6 6 1
1 1 1 1 1 1 1 1 1 1 1 1 1 1 1 1 1 1 1 1 1 1 1 1 1 1 1 1 1 1
